XXXXXXXXXXXXXXXXXXXXXXXXXXX
XWWWWWWWWWWWWWWWWWWWWWWWWWX
XWFFFCFFFFFFFWFFFFFFFRFFFWX
XWFWFWWFWWWWFWFWWWWFWWWWFWX
XWFWFWWFWWWWFWFWWWWFWWWWFWX
XWFFFFFFFFFFFFFFFFFFFFFFFWX
XWFWWWWFWFWWWWWWWFWFWWWWFWX
XWRFFFFFWFFFFWFCFFWFFFFFFWX
XWWWWWWFWWWWFWFWWWWFWWWWWWX
XWXXXXWCWFFFFFFFFFWFWXXXXWX
XWXXXXWFWFWWWGWWWFWFWXXXXWX
WWWWWWWFWFW0XUX1WFWFWWWWWWW
XDFFFFFFFFWXXUXXWFFFFFFFFDX
WWWWWWWFWFWXX2XXWFWFWWWWWWW
XWXXXXWFWFWWWWWWWFWFWXXXXWX
XWXXXXWFWFFFFPFFFFWCWXXXXWX
XWWWWWWFWWWWFWFWWWWFWWWWWWX
XWFCFFFFWFFFFWFFFFWFFFFFFWX
XWFWWWWFWFWWWWWWWFWFWWWWFWX
XWFFFFFFFFFFFFFFFFFFFFFCFWX
XWFWWWWFWWWWFWFWWWWFWWWWFWX
XWFWWWWFWWWWFWFWWWWFWWWWFWX
XWFFFCFFFFFFFWFFFFFFFFFFRWX
XWWWWWWWWWWWWWWWWWWWWWWWWWX
XXXXXXXXXXXXXXXXXXXXXXXXXXX