XXXXXXXXXXXXXXXXXXXXXXXXXXX
XWWWWWWWWWWWWWWWWWWWWWWWWWX
XWFFFFFFFFFFFFFFFFFFFFFFFWX
XWFCFWFWWFWWFWWFWWSWWFWFFWX
XWFFWFWWFWWFWWFWWFWWFWFFFWX
XWFFFFFFFFFFFFFFFFFFFFFFFWX
XWFWWWWFWFWWWWWWWFWFWWWWFWX
XWFFFTFFFFFFFFFFFFFFFRFFFWX
XWWWWWWFWWWWFWFWWWWFWWWWWWX
XWXXXXWFWFFFFFFFFFWFWXXXXWX
XWXXXXWFFFWWWGWWWFFFWXXXXWX
WWWWWWWFFFW0XUX1WFFFWWWWWWW
XDFFFFWFFFWXXUXXWFFFWFFFFDX
WWWWWFFFFFWXX2XXWFFFFFWWWWW
XWFFFFWFFFWWWWWWWFFFWFFFFWX
XWFFFFWFWFFFFPFFFFWFWFFFFWX
XWWWWWWFWFWWFFFWWFWFWWWWWWX
XWFFFFWFWFWXWFWXWFWFWFFFFWX
XWFWFFWFWFWWFFFWWFWFWFFWFWX
XWFFFFFFFFFFFFFFFFFFFFFFFWX
XWFWFFFFWWWWFFFWWWWFFFFWFWX
XWFFFFWFFFFFFWFFFFFFWFSFFWX
XWFFFCFFFFFFFFFFFFFFFFFFFWX
XWWWWWWWWWWWWWWWWWWWWWWWWWX
XXXXXXXXXXXXXXXXXXXXXXXXXXX