XXXXXXXXXXXXXXXXXXXXXXXXXXX
XWWWWWWWWWWWWWWWWWWWWWWWWWX
XWFFFFFSFFFFFWFFFFFFFFFFFWX
XWFWWWWFWWFWFWFWFWWFWWWWFWX
XWFWWWWFWWFWFWFWFWWFWWWWRWX
XWFFFFFWFFFFFFFFFFFWFFFFFWX
XWFWWWWFWFWWWTWWWFWFWWWWFWX
XWRFFFFFFFFFFWFFFFFFFFFFFWX
XWWWWWWFWWWWFWFWWWWFWWWWWWX
XWXXXXWFWFFFFFFFFFWFWXXXXWX
XWXXXXWFWFWWWGWWWFWFWXXXXWX
WWWWWWWFWFW0XUX1WFWFWWWWWWW
XDFFFFWFFFWXXUXXWFFFWFFFFDX
WWWWWFFFWFWXX2XXWFWFFFWWWWW
XWFFFFWFWFWWWWWWWFWFWFFFFWX
XWCFFFWFWFFFFPFFFFWFWFFFFWX
XWWWWWWFWFWWWWWWWFWFWWWWWWX
XWFFRFWFWFWXXWXXWFWFWFFFFWX
XWFWWWWFWFWWWWWWWFWFWWWWFWX
XWFFFFFFFFFFFFFFFFFFFFFFFWX
XWFWFFWFWWWWFWFWWWWFWCFWFWX
XWFWFFWFWWWWFFFWWWWFWFFWFWX
XWFFFFFFFFFFFWFFFFFFFFFFFWX
XWWWWWWWWWWWWWWWWWWWWWWWWWX
XXXXXXXXXXXXXXXXXXXXXXXXXXX